9898898989999898989988998889889889989999899888988889988999989888888888898998898898899889989988988888
999889999889998989998988989889989988898898898889X89888998889899889889988898X888988888888988989888999
99998888999999998998898889999998889888999898X899898989899989998889988999998888988899888999X899899998
8988998X8999889989888899998888989X88X88898889898X888988998889999998988899888X89989998989888988988988
898888899889989889988998888889889999998999998988889998X89988888999898998998X898899989988999988899998
998898X8988998988889888X89999988998898X898898898999988988899X899889889899889898989898889899988998898
88889899988998988898X89998999988998998988899X88888899989899989899888988898988888988888X8989898999899
9989888889999999999889888X88998989998888999889898989888988889988888898899888889899888999998988989899
989998899898989988989988889899888898X8888998X8988899889998889889899999888888X88999988899988899988X88
8989898888999999999888889898889988988988998889988998898888898999999898988998899999998988898998889888
9889989X8989899998999999999889898X89888X89888999888898898899X8899988998X8988X88999988889889988898X89
989988889889988998899999998999888989888889998998888989899988899988989988999898999999X899888899989988
988888X8889989888888889998899999X899999999989999888898998889X8889999989X899898999888988889X898888988
8988988999989899999988889899988989999889999989889988889888X8999998888899889X899999998988889889889898
88899988989888898988X89X8X898989X8998989899989988898989898899988898998998998X8989998X888988889889998
99888888998999899988889899888888899888998889X899X88898999988888989889999998998889898899989X889988998
8899888X889999889999889888988988X899X889988888889889988889898989998999889899898888998988889989999999
898898X8998989999889X88889998989899999888889X8898988899998X89988999989899898898888889999989989889988
9889899998999999888889888989999989888988899998988888889999888888898889898988888998988998889998998888
89X88899898998988889X8988989988889898888999898888989898988X8999889899899899999989898X898989888999888
88999999899998988989998X88998888X888899998998998889999899998999888888999X898899899899889998888989898
9989898999989998998999998X888989988988888988X898998999X898988999889999899988X88898889999998998889X89
988889X899898888899888999988889898898999998988998898899888989999998888889989989998998998899998999988
89X889888898998989998889898899988X8988899899889888989988888998998898988X8988998898998899989888899999
8898999X8898988998889999988988999999889999988898X89989898989998888888898X88X898989889988898889989998
9998898989998989898889888899888998898999889989999998889998898999999998988888889999888999999998889989
9899898888888998998899999998X88998998899989888989889999989X8X8899898999X8988X88889989999988899989889
989999X88998899999888888898888898X88889898898898988898898999899899989999889X898888899889999999998889
9899888889998988888889989889X888999899999989X889888899999999X89999999898X889X88899898988989998989889
898988X899899998989999989899889889888888989898998999989998988988999899999898988889889989989899998889
9989898999999898888988899998X8999999889X888999998898999999888889888898898998989999888889998989999X88
98X898889989899998899999998989998888X89899899988998998899989889898998998X88X89998889X899888999898899
998898X899888988898999898998X8898X88889888899988889989X89889X8889898888X8898X88989889888899999989889
9889988898998888999999989989899988989999999899998988898898X8898898999899998X888988898888998999898898
99998988889899989898888898989999X889899999899999X89899X888998999899999899998888989988899998888889889
99988989989899989989X8899X88898998888889888889989988898998998988988899989898X8998888X888999989889999
8998989999988888898898898899X8999X88898999888888989898999888998989888988889X889888989989888988988888
9898988888988988999888988X88999888989989888989888998899988X899889989888X8889999888898988899988988899
998899X88988988989889998999989888X889999999988988899899988899899999988989988999999898888989898989999
89899888899898998899998X898988898898989998999989888899888988899989898998889X88898889X889989889898888
9988898889998989889888898989X8888889988999999998X89898999988998899889999X888889888898889889889999888
989988889888988988888999888988899X898989898889989998988898998999989989888898999899999988888988999889
898999X8999888898899X8888889X8998998X8X88898X889898988X8888989989899899X899X89988898899988X889889889
89X8988998888889899988889X89898888889989998989898898989989X8898888899898888889888999X889989998898898
8999898989888998888888988989X899999899X89988X899999998999889X8988899989X89888988899889X8898988988898
889999X8898898898888889X8899988998989988889989899989989888999888888898998999X8889899998889X898989898
988999999988999989998888989998999X88999X8889X8898889888898898889889999998899999988988988898989888998
9889999999898899988989899998989999898989989988989999988988X89998999898898898999999899989999998999998
889988889989988889988899989888898888X88988988899889889X899988898989888988888999888899899898899889889
9889898999888989999889899899898889988889998888888989999999998999998989999999988988889999988888988898
8899998898889888899999898X898988898899X8899888898998889989889989998888898989888988988899988898999898
988989X88888988999989889989988998999898888888989999889899999989898998898X898X89889988899989989989X89
88X899989999998898899899999988998998998X888889998989999988888989999898899989998999898998988898989898
89888888999889998988989999889988X88898X898888998998989989999X88999898989988999988998898899X889998898
999999889989998988989889989889899999989X899888988989889898999998898889888888988988998889899898898998
9899888X8998999898898999889999899999898989888888998899989898899999888888X8899888999899X8999898899898
99999999999898998989X899889888888889X8999989X8899989989989988998898998999998998989888889988989888X88
9999888998999888888999888998X888X899989889999898899888998998X898989999898898898888988988898899888898
898889X8888998999899888X899988889999899999998999888998889999988998999888889X88988988998889X888989898
8888998898898998898988889889899888998889998889988888889988989898989889988899998889888888998989888898
898988X89988889999898998989888998X88X889999888988888888899888898888989899988998899889989898898988888
89898888988988999899888X8998X898899898898889898999899889988889998888998888899888989998X8888899999898
88X899899988989998898988899998988999899999889999988898888889998998989898X898998998999998989999999999
888898X8899888988989999X888998998888X898888888898889888899889898899998999889998988988988988999989988
8899898899988989889989988X8988998898998X88888988X89989999989898899998998999899898988X888899998898988
98898888999899999889999X8998X889888899888989X8888998899988X8889889889898899X889899888999898999899889
88X888899899999888988989889999998X89888888899989888898998988X88999898998888899998989X88998X899999X88
889888X8888998989889X888999999898988998888899998X8898988989999889888999889988889988999X8988999999989
88888988899998998998898889989899898898X88888988898988988898899889888898X889X899998999999988989989989
88X8898X89998999898899899999988999899998989889989889998898889988998899989999999988989888888999998899
899898X898889889998898898888889889989988988989889888988888999989998898899998889898989989988889999998
8899988999998999899999888X88X889898889X8988988899889989989988899999888889989X8988899989989X899989888
99989899888899889889999888898898X88999899899X899989898988988X8888889999X8888899999889898988988889999
99899899889988989999898898998998888888X8999888998889999999999998889888889998899999988888998899989899
99999889889898899888889X899988888889X8889988899889989888899898899888989X899X88998999999998X889889X88
89988888988899898898X8899989X89888899899998999899989998888888998989899888998898999899999899899989898
899999889888989898999899888998998998999988889998899899898899999999889989999X899898989889899899898X88
9989998X8999989999998999988998998999889888999989X8899999999988898899898988888889989989X8888988998889
98X8888888999989898989989X8989889999899888998988998989889899X89889988999X888899888988889898889899898
998988X8999988999989X8888898X8999898X88X89888989898889999989998989899899998999998999X888988899898898
98X88888888899889898889X899889999X899889999899999999899889888899898889888898898999999999899989989899
8999888X8998998889998899989899989899998998889989898888999899X8989989999X8888899989988988898999999889
889899999998899889888999889998988899889989889988X89999998889998988888889X888X88899988999898999998899
998898889898888999998999988988889X88899899998998898888998889988988888988888X89898988888988X899988X89
98X898X8889998898898X899899889988999X89X8898X888X88888888899889999888999998889899899X888989988888888
8898898888888998888889999889998999889998998999899989989998888988998989988898888888888899888988898X88
998889999999889989898989989898889898888X899899999889899888X8X88998988899X898X88998888988988998899999
98889899998889888898X8899X899998999889999988899989989999899988889988888998888988889889X8899989899998
88889989998999988898888998889999899899898988X898X899898899899989999989899989999999999988998998888989
89X89888999888898889X888889889999999888888888988898898888989998889898999988988989998899999X899999998
888998X8899998898999988X899989898899899X89988999998999888888989989898988989989889989X899888988888989
98X89898989989899999899989998899X88988898899X889898888X8989999998899889X8898888888889999998999889998
88888898999898889899X88888888988889888X889999888899899889889988888899988X888898889889988888899988989
99889988999898889889988X88898989X898889X89988898X88988X889999889989999999889999888899899998999898999
89X8988X89898998998898989898X89898898898899999998988998999989998889989999988898998989988988988899988
989998X89898898999989988888899889X89889X88898899898898899999899888988898999X898989998888999989889989
8989898898899998888988889898988888988899899999989988988888889988899899999898X8899989X889989999889889
98899888988989999889898X889999989X889999999998989889888888898898988899899899989889999899889989989888
89X8988998988999999888899998998999898989999888898889888898889989999889898998889888988898989888898999
8888889899889989889988888898888989889989888988989999988998999888999988898989889899988889889999888898